          ┌───┐┌────────┐┌───┐┌───┐              
          │   ├┤        ├┤   ││   │              
          │   │└────────┘└─┬─┘│   │              
┌───┐┌───┐│   │┌───────────┴─┐│   │┌───┐         
│   ├┤   ├┤   ├┤             ├┤   ├┤   │         
└───┘└───┘│   │└─┬─────────┬─┘│   │└───┘         
          │   │┌─┴─┐┌───┐┌─┴─┐│   │    ┌─────────┐
          │   ├┤   ├┤   ├┤   ││   │    │         │
          └───┘└───┘└───┘└───┘└───┘    └─┬───┐   │
                                 ┌───┐ ┌─┴─┐ │   │
                                 │   ├─┤   │ │   │
                                 └─┬─┘ └───┘ └─┬─┘
                                 ┌─┴───────────┴─┐
                                 │               │
                                 └───────────────┘
