            ┌────┐┌──────────┐┌────┐┌────┐                      
            │    ├┤          ├┤    ││    │                      
            │    ││          ││    ││    │                      
            │    │└──────────┘└──┬─┘│    │                      
┌────┐┌────┐│    │┌──────────────┴─┐│    │┌────┐                
│    ├┤    ├┤    ├┤                ├┤    ├┤    │                
│    ││    ││    ││                ││    ││    │                
└────┘└────┘│    │└─┬────────────┬─┘│    │└────┘                
            │    │┌─┴──┐┌────┐┌──┴─┐│    │                      
            │    ││    ││    ││    ││    │   ┌───────────┐      
            │    ├┤    ├┤    ├┤    ├┤    │   │           │      
            └────┘└────┘└────┘└────┘└────┘   │           │      
                                             └─┬────┐    │      
                                      ┌────┐ ┌─┴──┐ │    │      
                                      │    │ │    │ │    │      
                                      │    │ │    │ │    │      
                                      └┬───┘ └────┘ └───┬┘      
                                      ┌┴────────────────┴┐      
                                      │                  │      
                                      │                  │      
                                      └──────────────────┘      
